hgoojfi	HGOOJFI
efbgo	EFBGO
hcgjiom	HCGJIOM
oml	OML
jael	JAEL
kkp	KKP
cbjdh	CBJDH
jkimmij	JKIMMIJ
oahlcoddoona	OAHLCODDOONA
oe	OE
ao	AO
cka	CKA
kjh	KJH
kojfoh	KOJFOH
gmp	GMP
ooecb	OOECB
hcplle	HCPLLE
hcpdnjg	HCPDNJG
hmmmheig	HMMMHEIG
cjjba	CJJBA
eppnahk	EPPNAHK
nkinia	NKINIA
jnbm	JNBM
bikime	BIKIME
mcmhmdfjm	MCMHMDFJM
hkci	HKCI
mgni	MGNI
kobk	KOBK
ccff	CCFF
nigenai	NIGENAI
cdl	CDL
mjogb	MJOGB
dg	DG
jghcc	JGHCC
cdbaf	CDBAF
jefjdge	JEFJDGE
fanjfofo	FANJFOFO
mfh	MFH
opnceel	OPNCEEL
jfndl	JFNDL
fnjibl	FNJIBL
oll	OLL
nomi	NOMI
if	IF
on	ON
dcccmcme	DCCCMCME
g	G
ljin	LJIN
plmp	PLMP
jba	JBA
jec	JEC
bhjb	BHJB
jplgcof	JPLGCOF
cdbp	CDBP
llggp	LLGGP
dj	DJ
gah	GAH
hgeeph	HGEEPH
fgi	FGI
fkbghm	FKBGHM
dfmoo	DFMOO
ln	LN
cgcglbl	CGCGLBL
pkad	PKAD
mom	MOM
eco	ECO
lod	LOD
gngbd	GNGBD
ipgcgb	IPGCGB
mme	MME
aebe	AEBE
jimlpe	JIMLPE
gmlocmk	GMLOCMK
keckol	KECKOL
cdgeei	CDGEEI
olef	OLEF
pogbga	POGBGA
g	G
eddgai	EDDGAI
hpejela	HPEJELA
nnpfpk	NNPFPK
lnekohce	LNEKOHCE
glki	GLKI
difif	DIFIF
cgpl	CGPL
gckbpfepnig	GCKBPFEPNIG
plodbpi	PLODBPI
dedl	DEDL
beeibofke	BEEIBOFKE
cpf	CPF
inblklpagf	INBLKLPAGF
je	JE
ebfp	EBFP
pgjig	PGJIG
c	C
pdg	PDG
p	P
ojd	OJD
ciolbbgb	CIOLBBGB
gmgicnd	GMGICND
