ayılmak	ayıldık	V;IND;1;PL;PST;POS;DECL
zorluk	zorluğun	N;GEN;SG
deve	develeri	N;ACC;PL
bulamak	buladım	V;IND;1;SG;PST;POS;DECL
daldırtmak	daldırtacaklar mı?	V;IND;3;PL;FUT;POS;INTR
uyruk	uyruklarda	N;LOC;PL
biseksüel	biseksüelimizin	N;GEN;SG;PSS1P
altın	altınlarına	N;DAT;PL;PSS3S
kullanmak	kullanacak mısınız?	V;IND;2;PL;FUT;POS;INTR
pirinç	pirincinize	N;DAT;SG;PSS2P
polen	polendiniz	N;LGSPEC1;2P;SG;PST
gücenmek	gücenmedim mi?	V;IND;1;SG;PST;NEG;INTR
bahçıvan	bahçıvanında	N;LOC;SG;PSS3S
afiyet	afiyetlerinin	N;GEN;PL;PSS2S
kaynaştırtılmak	kaynaştırtılmayacaksın	V;IND;2;SG;FUT;NEG;DECL
aşık atmak	aşık attın mı?	V;IND;2;SG;PST;POS;INTR
dişlek	dişleklerinde	N;LOC;SG;PSS3P
askı	askılarından	N;ABL;PL;PSS2S
yalıtım	yalıtımlardan	N;ABL;PL
çiş	çişlerimizin	N;GEN;PL;PSS1P
kovdurmak	kovdurdum mu?	V;IND;1;SG;PST;POS;INTR
kuğu	kuğuya	N;DAT;SG
mısra	mısralarda	N;LOC;PL
ip	ipinizin	N;GEN;SG;PSS2P
sürücü	sürücülerine	N;DAT;PL;PSS2S
seçmen	seçmenmişsiniz	N;LGSPEC1;2P;SG;LGSPEC2
haberleşmek	haberleşiyordu	V;IND;3;SG;PST;PROG;POS;DECL
cibinlik	cibinliğinde	N;LOC;SG;PSS2S
diyapazon	diyapazonumuzun	N;GEN;SG;PSS1P
barış	barışlarınızda	N;LOC;PL;PSS2P
sosyolog	sosyologlardan	N;ABL;PL
öldürtmek	öldürtmediniz mi?	V;IND;2;PL;PST;NEG;INTR
kuyumcu	kuyumcuydular	N;LGSPEC1;3P;SG;PST
otuz birci	otuz bircinizde	N;LOC;SG;PSS2P
giysi	giysi	N;LGSPEC1;3S;SG;PRS
telofaz	telofazlarımıza	N;DAT;PL;PSS1P
havra	havraların	N;NOM;PL;PSS2S
birliktelik	birlikteliğinizden	N;ABL;SG;PSS2P
daldırtmak	daldırtdınız	V;IND;2;PL;PST;POS;DECL
odak	odağın	N;GEN;SG
rubai	rubailerimizde	N;LOC;PL;PSS1P
canlandırtılmak	canlandırtılmıyor musun?	V;IND;2;SG;PRS;PROG;NEG;INTR
üvey çocuk	üvey çocuklarını	N;ACC;PL;PSS3S
beyit	beyitlerdiniz	N;LGSPEC1;2P;PL;PST
ot	otlarından	N;ABL;PL;PSS2S
kanıtlamak	kanıtlıyor muyduk?	V;IND;1;PL;PST;PROG;POS;INTR
zartayı çekmek	zartayı çekmiyorlar	V;IND;3;PL;PRS;PROG;NEG;DECL
benek	beneğiniz	N;NOM;SG;PSS2P
kolye	kolyelerinden	N;ABL;PL;PSS2S
davranışçılık	davranışçılığının	N;GEN;SG;PSS3S
diferansiyel denklem	diferansiyel denklemlerimizde	N;LOC;PL;PSS1P
kiler	kilerinin	N;GEN;SG;PSS3S
radyoaktif parçalanma	radyoaktif parçalanmanda	N;LOC;SG;PSS2S
gözlemek	gözlüyorsunuz	V;IND;2;PL;PRS;PROG;POS;DECL
kıyı	kıyılarına	N;DAT;PL;PSS2S
tartmak	tarttılar	V;IND;3;PL;PST;POS;DECL
rahmetli olmak	rahmetli olursunuz	V;IND;2;PL;PRS;POS;DECL
fetiş	fetişlerinde	N;LOC;PL;PSS3P
sahife	sahifelerinizden	N;ABL;PL;PSS2P
evcil sinek	evcil sineklerin	N;NOM;PL;PSS2S
sayım	sayımlarda	N;LOC;PL
işlemek	işlemeyecek miyiz?	V;IND;1;PL;FUT;NEG;INTR
çavuş	çavuşumuzdan	N;ABL;SG;PSS1P
batmak	batmadılar mı?	V;IND;3;PL;PST;NEG;INTR
banka	bankalarına	N;DAT;PL;PSS2S
üçlü	üçlülerde	N;LOC;PL
geyik	geyiklerine	N;DAT;PL;PSS3P
kastanyet	kastanyetinden	N;ABL;SG;PSS3S
sille	sillesine	N;DAT;SG;PSS3S
nokta	noktalarından	N;ABL;PL;PSS3S
semer	semeri	N;ACC;SG
gazel	gazelinizden	N;ABL;SG;PSS2P
pijama	pijamama	N;DAT;SG;PSS3P
köçek	köçektik	N;LGSPEC1;1P;SG;PST
yapışmak	yapışır mı?	V;IND;3;SG;PRS;POS;INTR
kaybolmak	kayboluyoruz	V;IND;1;PL;PRS;PROG;POS;DECL
şahmerdan	şahmerdan	N;NOM;SG
köpük bellek	köpük belleklerinden	N;ABL;PL;PSS2S
bağlamak	bağlayacaksınız	V;IND;2;PL;FUT;POS;DECL
geğirmek	geğireceksiniz	V;IND;2;PL;FUT;POS;DECL
odacı	odacıymışsın	N;LGSPEC1;2S;SG;LGSPEC2
savaşçı	savaşçımızın	N;GEN;SG;PSS1P
kaynaşmak	kaynaştın mı?	V;IND;2;SG;PST;POS;INTR
geçmek	geçmiyordular	V;IND;3;PL;PST;PROG;NEG;DECL
olay güdümlü programlama	olay güdümlü programlamaya	N;DAT;SG
topçu	topçun	N;NOM;SG;PSS2S
orta	ortalarsınız	N;LGSPEC1;2P;PL;PRS
bıçaklamak	bıçaklamadı	V;IND;3;SG;PST;NEG;DECL
deli	deliymişiz	N;LGSPEC1;1P;SG;LGSPEC2
yakışıklı	yakışıklı değil miyiz?	ADJ;LGSPEC1;PRS;1;PL;NEG;INTR
prezervatif	prezervatifine	N;DAT;SG;PSS3S
dılak	dılağınızdan	N;ABL;SG;PSS2P
krep	krepleri	N;NOM;PL;PSS3P
almak	alıyordun	V;IND;2;SG;PST;PROG;POS;DECL
ipek	ipeklerinin	N;GEN;PL;PSS3P
bomba	bombasına	N;DAT;SG;PSS3S
sıralama	sıralamasında	N;LOC;SG;PSS3S
küsmek	küsüyorlar	V;IND;3;PL;PRS;PROG;POS;DECL
mistik	mistiğe	N;DAT;SG
ahtapot	ahtapotumuzu	N;ACC;SG;PSS1P
kenar	kenarın	N;GEN;SG
ombudsman	ombudsmanlarımız	N;NOM;PL;PSS1P
boyamak	boyuyorum	V;IND;1;SG;PRS;PROG;POS;DECL
çift	çiftlerinizi	N;ACC;PL;PSS2P
tıkmak	tıkacak mısınız?	V;IND;2;PL;FUT;POS;INTR
ölü	ölüleri	N;ACC;PL
kullanıcı	kullanıcılarına	N;DAT;PL;PSS2S
tekila	tekilanıza	N;DAT;SG;PSS2P
soğurmak	soğurmazlar mı?	V;IND;3;PL;PRS;NEG;INTR
metafaz	metafazlara	N;DAT;PL
çıkarmak	çıkarmadım mı?	V;IND;1;SG;PST;NEG;INTR
korkutmak	korkutmayız	V;IND;1;PL;PRS;NEG;DECL
alındırtmak	alındırtıyordu	V;IND;3;SG;PST;PROG;POS;DECL
lisan	lisanı	N;ACC;SG
içmek	içtiler	V;IND;3;PL;PST;POS;DECL
interfaz	interfazına	N;DAT;SG;PSS3S
hedef	hedefi	N;ACC;SG
sözcülük	sözcülüğünüzün	N;GEN;SG;PSS2P
rakı	rakılarında	N;LOC;PL;PSS2S
doymak	doymayacak mısın?	V;IND;2;SG;FUT;NEG;INTR
bilezik	bileziklerimize	N;DAT;PL;PSS1P
bitmek	bitmiyorlar	V;IND;3;PL;PRS;PROG;NEG;DECL
primitif	primitif değilmişsiniz	ADJ;LGSPEC1;LGSPEC2;2;PL;NEG;DECL
eldiven	eldivenin	N;GEN;SG
savaş	savaşlarının	N;GEN;PL;PSS2S
milimetre	milimetrelerimizi	N;ACC;PL;PSS1P
şemsiye	şemsiyeydiler	N;LGSPEC1;3P;SG;PST
rahatsızlanmak	rahatsızlanmadın mı?	V;IND;2;SG;PST;NEG;INTR
kötüleşmek	kötüleşmezler mi?	V;IND;3;PL;PRS;NEG;INTR
toz	tozmuşuz	N;LGSPEC1;1P;SG;LGSPEC2
canlandırmamak	canlandırıyor muydunuz?	V;IND;2;PL;PST;PROG;POS;INTR
uğratılmak	uğratılıyor	V;IND;3;SG;PRS;PROG;POS;DECL
kartpostal	kartpostalın	N;NOM;SG;PSS2S
pisletmek	pisletmiyorduk	V;IND;1;PL;PST;PROG;NEG;DECL
zavar	zavarlarından	N;ABL;PL;PSS2S
oje	ojesinin	N;GEN;SG;PSS3S
havadan havaya füze	havadan havaya füzelerinde	N;LOC;PL;PSS2S
salata	salataymışsınız	N;LGSPEC1;2P;SG;LGSPEC2
neden	nedenlermişsin	N;LGSPEC1;2S;PL;LGSPEC2
it	itlerini	N;ACC;PL;PSS2S
titremek	titreyecekler	V;IND;3;PL;FUT;POS;DECL
bitme	bitmemden	N;ABL;SG;PSS3P
kelimecik	kelimeciğinde	N;LOC;SG;PSS3S
ulam	ulamlarmışsınız	N;LGSPEC1;2P;PL;LGSPEC2
sahip	sahipleriniz	N;NOM;PL;PSS2P
sosluk	sosluklarının	N;GEN;PL;PSS3P
takvim	takvimlerini	N;ACC;PL;PSS3S
başarmak	başardım	V;IND;1;SG;PST;POS;DECL
kovmamak	kovdum mu?	V;IND;1;SG;PST;POS;INTR
süt sağmak	süt sağmıyor muydunuz?	V;IND;2;PL;PST;PROG;NEG;INTR
yendirmek	yendiriyor muydunuz?	V;IND;2;PL;PST;PROG;POS;INTR
disko	diskolarınız	N;NOM;PL;PSS2P
üşenmek	üşenmiyor muyduk?	V;IND;1;PL;PST;PROG;NEG;INTR
yolundurmak	yolundurmadılar mı?	V;IND;3;PL;PST;NEG;INTR
tekdillilik	tekdilliliklerinize	N;DAT;PL;PSS2P
baraj	barajlarında	N;LOC;PL;PSS3P
aldatmak	aldattınız mı?	V;IND;2;PL;PST;POS;INTR
oyalamak	oyalamıyor muydum?	V;IND;1;SG;PST;PROG;NEG;INTR
direk	direklerimiz	N;NOM;PL;PSS1P
yanıt vermek	yanıt vermiyor muyum?	V;IND;1;SG;PRS;PROG;NEG;INTR
ucube	ucubeymişiz	N;LGSPEC1;1P;SG;LGSPEC2
saldırmak	saldırdı mı?	V;IND;3;SG;PST;POS;INTR
kupür	kupürümün	N;GEN;SG;PSS3P
derleme	derlemesini	N;ACC;SG;PSS3S
müellif	müelliflermişsin	N;LGSPEC1;2S;PL;LGSPEC2
köpük	köpüklerinde	N;LOC;PL;PSS3P
yermek	yermiyor muydu?	V;IND;3;SG;PST;PROG;NEG;INTR
metrdotel	metrdotellerin	N;GEN;PL
üstveri	üstverinizde	N;LOC;SG;PSS2P
havlu atmak	havlu atacak mıyım?	V;IND;1;SG;FUT;POS;INTR
sincap	sincaplara	N;DAT;PL
pelin	pelinleri	N;NOM;SG;PSS3P
angut	angutlarımızdan	N;ABL;PL;PSS1P
kansızlık	kansızlıkların	N;NOM;PL;PSS2S
vermek	vermiyoruz	V;IND;1;PL;PRS;PROG;NEG;DECL
sinagog	sinagoglarımızı	N;ACC;PL;PSS1P
patlamak	patlayacağım	V;IND;1;SG;FUT;POS;DECL
baston	bastonun	N;NOM;SG;PSS2S
hayalî arkadaş	hayalî arkadaşta	N;LOC;SG
yermek	yermiyorsun	V;IND;2;SG;PRS;PROG;NEG;DECL
iyelik	iyeliklerine	N;DAT;PL;PSS3S
polis akademisi	polis akademilerini	N;ACC;PL
gülünçleşmek	gülünçleşirsiniz	V;IND;2;PL;PRS;POS;DECL
kaltak	kaltağa	N;DAT;SG
ropdöşambır	ropdöşambırının	N;GEN;SG;PSS3S
yetkili sunucu	yetkili sunucularının	N;GEN;PL;PSS2S
kaside	kasidelerine	N;DAT;PL;PSS3S
sağduyu	sağduyulara	N;DAT;PL
yolcu	yolcunun	N;GEN;SG
cep	cepten	N;ABL;SG
lezbiyen	lezbiyenleriz	N;LGSPEC1;1P;PL;PRS
ördek	ördeğinin	N;GEN;SG;PSS3S
âlim	âlimlerinize	N;DAT;PL;PSS2P
cinsel yönelim	cinsel yönelimlerine	N;DAT;PL;PSS3S
çökerti	çökertilerini	N;ACC;PL;PSS3P
efsun	efsunlarınızda	N;LOC;PL;PSS2P
ziyaretçi	ziyaretçilerinde	N;LOC;PL;PSS3S
çöpçatan	çöpçatanlarından	N;ABL;SG;PSS3P
mancınık	mancınıklarında	N;LOC;SG;PSS3P
örtü	örtüleriz	N;LGSPEC1;1P;PL;PRS
balıkçı	balıkçıydı	N;LGSPEC1;3S;SG;PST
taraf	taraflarından	N;ABL;PL;PSS3P
sütyen	sütyene	N;DAT;SG
gizlemek	gizliyorlar mı?	V;IND;3;PL;PRS;PROG;POS;INTR
çiş	çişlerine	N;DAT;SG;PSS3P
yan cümle	yan cümlemize	N;DAT;SG;PSS1P
sözcük	sözcüklerinde	N;LOC;PL;PSS2S
sattırmak	satırtmazlar	V;IND;3;PL;PRS;NEG;DECL
ped	pedlerinin	N;GEN;PL;PSS3S
zakkum	zakkumlarda	N;LOC;PL
kaybolmak	kaybolmadınız	V;IND;2;PL;PST;NEG;DECL
kirletmek	kirletecekler mi?	V;IND;3;PL;FUT;POS;INTR
balıkçı	balıkçıların	N;NOM;PL;PSS2S
sakal	sakalından	N;ABL;SG;PSS2S
sınamak	sınamaz mıyız?	V;IND;1;PL;PRS;NEG;INTR
blogcu	blogcumuz	N;NOM;SG;PSS1P
ipek	ipekleri	N;NOM;PL;PSS3P
valiz	valizlerinde	N;LOC;PL;PSS3S
granüllü endoplazmik retikulum	granüllü endoplazmik retikulumuna	N;DAT;SG;PSS2S
hareketsizlik	hareketsizliklerine	N;DAT;PL;PSS3P
ulus	uluslarımızı	N;ACC;PL;PSS1P
kist	kistlerdik	N;LGSPEC1;1P;PL;PST
anahtarlık	anahtarlıklar	N;NOM;PL
doktor	doktorlarınızda	N;LOC;PL;PSS2P
sıvılaşmak	sıvılaşıyor muydum?	V;IND;1;SG;PST;PROG;POS;INTR
masa	masalar	N;NOM;PL
sinirlendirmek	sinirlendirmeyecek misin?	V;IND;2;SG;FUT;NEG;INTR
akşamdan kalma	akşamdan kalmalarmışsın	N;LGSPEC1;2S;PL;LGSPEC2
eşantiyon	eşantiyonlar	N;NOM;PL
yayımcılık	yayımcılıklara	N;DAT;PL
çilek	çileklerinizin	N;GEN;PL;PSS2P
salam	salamlarınızın	N;GEN;PL;PSS2P
papaz olmak	papaz olur mıyım?	V;IND;1;SG;PRS;POS;INTR
aşmak	aşacaksın	V;IND;2;SG;FUT;POS;DECL
nöron	nöronları	N;NOM;PL;PSS3P
ped	pedlerinizin	N;GEN;PL;PSS2P
ittirilmek	ittiriliyorlardı	V;IND;3;PL;PST;PROG;POS;DECL
donma	donmalarını	N;ACC;PL;PSS3P
köpek	köpekte	N;LOC;SG
sempozyum	sempozyumumuza	N;DAT;SG;PSS1P
küremek	küremiyor muydunuz?	V;IND;2;PL;PST;PROG;NEG;INTR
kurumak	kurumuyor muyuz?	V;IND;1;PL;PRS;PROG;NEG;INTR
zafer	zaferlerinden	N;ABL;SG;PSS3P
jöle	jölenizi	N;ACC;SG;PSS2P
sanatçı	sanatçılarda	N;LOC;PL
piyano	piyanolarına	N;DAT;PL;PSS3P
aşık atmak	aşık atacağız	V;IND;1;PL;FUT;POS;DECL
evlenmek	evlenmiyor muyuz?	V;IND;1;PL;PRS;PROG;NEG;INTR
yanıt vermek	yanıt vermedim mi?	V;IND;1;SG;PST;NEG;INTR
sis	sislerimize	N;DAT;PL;PSS1P
meşe	meşelerinizden	N;ABL;PL;PSS2P
bakıcı	bakıcılardın	N;LGSPEC1;2S;PL;PST
asker	askerlerinde	N;LOC;PL;PSS2S
küpe	küpende	N;LOC;SG;PSS2S
bulgur	bulgurunuzda	N;LOC;SG;PSS2P
tulum	tulumlarınızda	N;LOC;PL;PSS2P
dövmek	dövmüyor muyuz?	V;IND;1;PL;PRS;PROG;NEG;INTR
totemcilik	totemciliklerden	N;ABL;PL
yolculuk	yolculuğundan	N;ABL;SG;PSS2S
taç	taçlarını	N;ACC;SG;PSS3P
noktürn	noktürnümün	N;GEN;SG;PSS3P
keser	kesermızdan	N;ABL;SG;PSS1P
belirli integral	belirli integrallerine	N;DAT;PL;PSS3P
kovboy	kovboylardan	N;ABL;PL
tepmek	tepmez mi?	V;IND;3;SG;PRS;NEG;INTR
aikido	aikidolara	N;DAT;PL
devinmek	deviniyorlar	V;IND;3;PL;PRS;PROG;POS;DECL
ceviz	cevizlere	N;DAT;PL
masumiyet	masumiyetinden	N;ABL;SG;PSS2S
jöle	jölem	N;NOM;SG;PSS3P
bildirmek	bildirmeyeceğim	V;IND;1;SG;FUT;NEG;DECL
kitabe	kitabelerinde	N;LOC;PL;PSS3P
fren	frenlerini	N;ACC;PL;PSS2S
şüphe	şüpheydin	N;LGSPEC1;2S;SG;PST
koklamak	koklamıyoruz	V;IND;1;PL;PRS;PROG;NEG;DECL
güneş	güneşlere	N;DAT;PL
emlak	emlağı	N;NOM;SG;PSS3S
üyelik	üyeliğini	N;ACC;SG;PSS2S
ilim	ilminiz	N;NOM;SG;PSS2P
delmek	delmeyecek	V;IND;3;SG;FUT;NEG;DECL
çevirmek	çevirdim	V;IND;1;SG;PST;POS;DECL
dış ağ	dış ağı	N;NOM;SG;PSS3S
yayımcılık	yayımcılıklarından	N;ABL;PL;PSS2S
sözlük	sözlüğümüzün	N;GEN;SG;PSS1P
sözlükçü	sözlükçüler	N;LGSPEC1;3P;SG;PRS
dermek	dermez	V;IND;3;SG;PRS;NEG;DECL
şaşılmak	şaşılacağım	V;IND;1;SG;FUT;POS;DECL
ten	tenlerinize	N;DAT;PL;PSS2P
makina	makinalar	N;LGSPEC1;3P;SG;PRS
sararmak	sararıyoruz	V;IND;1;PL;PRS;PROG;POS;DECL
boğmak	boğdunuz mu?	V;IND;2;PL;PST;POS;INTR
şikâyet etmek	şikâyet edersiniz	V;IND;2;PL;PRS;POS;DECL
granüllü endoplazmik retikulum	granüllü endoplazmik retikulumlarımızın	N;GEN;PL;PSS1P
kruvasan	kruvasanlarının	N;GEN;PL;PSS3P
avcı	avcılardınız	N;LGSPEC1;2P;PL;PST
kaybolmak	kayboldu	V;IND;3;SG;PST;POS;DECL
eğlence	eğlenceymişsin	N;LGSPEC1;2S;SG;LGSPEC2
paten	patenlerini	N;ACC;PL;PSS2S
mikrofiber	mikrofiberine	N;DAT;SG;PSS2S
kolonya	kolonyaydın	N;LGSPEC1;2S;SG;PST
sözdizimsel tuz	sözdizimsel tuzları	N;ACC;PL
kopmak	kopuyor musunuz?	V;IND;2;PL;PRS;PROG;POS;INTR
vitrin	vitrinleriniz	N;NOM;PL;PSS2P
oyuncu	oyuncunun	N;GEN;SG;PSS2S
soyut arayüz	soyut arayüzüm	N;NOM;SG;PSS3P
koz	kozlarına	N;DAT;PL;PSS3P
sapmak	sapmıyor musunuz?	V;IND;2;PL;PRS;PROG;NEG;INTR
gitme	gitmemin	N;GEN;SG;PSS3P
tutuşturmak	tutuşturduk mu?	V;IND;1;PL;PST;POS;INTR
psikolog	psikologlar	N;NOM;PL
cehennem	cehennemlerimizde	N;LOC;PL;PSS1P
uygulama	uygulamalarından	N;ABL;PL;PSS3S
dilber	dilberlerde	N;LOC;PL
dik üçgen	dik üçgenden	N;ABL;SG
artı sayı	artı sayılarından	N;ABL;PL;PSS3P
oda	oda	N;NOM;SG
disleksi	disleksinden	N;ABL;SG;PSS2S
gezmek	gezmez misin?	V;IND;2;SG;PRS;NEG;INTR
koku	kokuyu	N;ACC;SG
yuvarlamak	yuvarlaacak mı?	V;IND;3;SG;FUT;POS;INTR
sarılmak	sarılmıyor musunuz?	V;IND;2;PL;PRS;PROG;NEG;INTR
kıllık	kıllıklarından	N;ABL;SG;PSS3P
silah	silahlardan	N;ABL;PL
çavuş	çavuşundan	N;ABL;SG;PSS3S
mikrofon	mikrofonlarda	N;LOC;PL
tek sayı	tek sayıların	N;GEN;PL
sekreter	sekreterleri	N;ACC;PL
ayakkabı	ayakkabısının	N;GEN;SG;PSS3S
uyarı	uyarılar	N;NOM;PL
güvenmek	güvenmiyordunuz	V;IND;2;PL;PST;PROG;NEG;DECL
halk	halklarını	N;ACC;PL;PSS2S
leş	leştiniz	N;LGSPEC1;2P;SG;PST
yontulmak	yontulmuyordu	V;IND;3;SG;PST;PROG;NEG;DECL
parçalanmak	parçalanacak mısınız?	V;IND;2;PL;FUT;POS;INTR
papa	papamızda	N;LOC;SG;PSS1P
güvensizlik	güvensizliklerinden	N;ABL;PL;PSS2S
canlanmak	canlanmadınız	V;IND;2;PL;PST;NEG;DECL
havadan karaya füze	havadan karaya füzen	N;NOM;SG;PSS2S
şaşırtmak	şaşırtacak mıyım?	V;IND;1;SG;FUT;POS;INTR
çürümek	çürüyor muydum?	V;IND;1;SG;PST;PROG;POS;INTR
üzülmek	üzülüyor musunuz?	V;IND;2;PL;PRS;PROG;POS;INTR
yamuk	yamuğun	N;GEN;SG
güvenlilik	güvenliliğinden	N;ABL;SG;PSS2S
içmek	içmeyecek misiniz?	V;IND;2;PL;FUT;NEG;INTR
toz	tozduk	N;LGSPEC1;1P;SG;PST
palindrom	palindroma	N;DAT;SG
uyuşturucu	uyuşturucularınız	N;NOM;PL;PSS2P
süzmek	süzmeyecek miyim?	V;IND;1;SG;FUT;NEG;INTR
yontulmak	yontulduk	V;IND;1;PL;PST;POS;DECL
primitif	primitifler	ADJ;LGSPEC1;PRS;3;PL;POS;DECL
cızlamı çekmek	cızlamı çekmediniz mi?	V;IND;2;PL;PST;NEG;INTR
şaşırttırmak	şaşırttırmaz mı?	V;IND;3;SG;PRS;NEG;INTR
bıçaklamak	bıçaklamıyor	V;IND;3;SG;PRS;PROG;NEG;DECL
yöre	yöreye	N;DAT;SG
verdirmek	verdirmiyorduk	V;IND;1;PL;PST;PROG;NEG;DECL
gaf	gaflarından	N;ABL;PL;PSS2S
solumak	soluyordum	V;IND;1;SG;PST;PROG;POS;DECL
tasarruf	tasarrufunun	N;GEN;SG;PSS2S
buse	buse	N;NOM;SG
emmek	emiyorsun	V;IND;2;SG;PRS;PROG;POS;DECL
yakışıklı	yakışıklı değil mi?	ADJ;LGSPEC1;PRS;3;SG;NEG;INTR
beklemek	bekliyoruz	V;IND;1;PL;PRS;PROG;POS;DECL
fakirleştirmek	fakirleştiriyor mu?	V;IND;3;SG;PRS;PROG;POS;INTR
fotoğrafçı	fotoğrafçısı	N;NOM;SG;PSS3S
gelincik	gelinciği	N;ACC;SG
coşku	coşkunun	N;GEN;SG
cezalandırmak	cezalandırmıyor mu?	V;IND;3;SG;PRS;PROG;NEG;INTR
fortlamak	fortlamıyorlar mıydı?	V;IND;3;PL;PST;PROG;NEG;INTR
tosbağa	tosbağanızdan	N;ABL;SG;PSS2P
taklit	taklidinin	N;GEN;SG;PSS3S
senaryo	senaryoları	N;NOM;PL;PSS3P
dedikodu	dedikodularınızın	N;GEN;PL;PSS2P
milyoner	milyonerlerinin	N;GEN;PL;PSS3S
yanıt vermek	yanıt vermiyorum	V;IND;1;SG;PRS;PROG;NEG;DECL
yalıtım	yalıtımları	N;NOM;SG;PSS3P
umman	ummandan	N;ABL;SG
kurbağa	kurbağama	N;DAT;SG;PSS3P
dadı	dadısına	N;DAT;SG;PSS3S
blogcu	blogcusunun	N;GEN;SG;PSS3S
bitmek	bittiniz	V;IND;2;PL;PST;POS;DECL
ittirmek	ittirmiyorduk	V;IND;1;PL;PST;PROG;NEG;DECL
kullanılmak	kullanılıyor mu?	V;IND;3;SG;PRS;PROG;POS;INTR
odacı	odacımın	N;GEN;SG;PSS3P
albatros	albatrosundan	N;ABL;SG;PSS2S
emmi	emmimde	N;LOC;SG;PSS3P
kat	katlarınızdan	N;ABL;PL;PSS2P
karşılık	karşılığını	N;ACC;SG;PSS3S
misket	misketlerine	N;DAT;PL;PSS2S
dövmek	dövdünüz mü?	V;IND;2;PL;PST;POS;INTR
izolasyon	izolasyonunuza	N;DAT;SG;PSS2P
korunma	korunmam	N;NOM;SG;PSS3P
senkretizm	senkretizmlerinin	N;GEN;SG;PSS3P
tulum	tulumumuzun	N;GEN;SG;PSS1P
ayrılma durumu	ayrılma durumuna	N;DAT;SG
seyretmek	seyretiyordun	V;IND;2;SG;PST;PROG;POS;DECL
üretici	üreticide	N;LOC;SG
ek	ekiz	N;LGSPEC1;1P;SG;PRS
yangın	yangınlarmışsınız	N;LGSPEC1;2P;PL;LGSPEC2
sınav	sınavda	N;LOC;SG
çiçe	çiçelerinizi	N;ACC;PL;PSS2P
coşku	coşkularımızda	N;LOC;PL;PSS1P
abajurcu	abajurcunuzu	N;ACC;SG;PSS2P
yağlamak	yağlamadın mı?	V;IND;2;SG;PST;NEG;INTR
süspansuvar	süspansuvarını	N;ACC;SG;PSS3S
yavşak	yavşaklarınızın	N;GEN;PL;PSS2P
kış uykusuna yatmak	kış uykusuna yatmıyor musun?	V;IND;2;SG;PRS;PROG;NEG;INTR
müzisyen	müzisyenlerimizden	N;ABL;PL;PSS1P
kalmak	kalmıyordunuz	V;IND;2;PL;PST;PROG;NEG;DECL
uğratılmak	uğratılmıyorsun	V;IND;2;SG;PRS;PROG;NEG;DECL
alt	alta	N;DAT;SG
dağıtım	dağıtımı	N;ACC;SG
yetki	yetkilerinin	N;GEN;PL;PSS3S
atılmak	atılmazsın	V;IND;2;SG;PRS;NEG;DECL
anonim şirketi	anonim şirketlerini	N;ACC;PL
temizlemek	temizlersin	V;IND;2;SG;PRS;POS;DECL
in	inlerinizi	N;ACC;PL;PSS2P
vurmak	vuruyorsunuz	V;IND;2;PL;PRS;PROG;POS;DECL
umutsuz	umutsuz muyduk?	ADJ;LGSPEC1;PST;1;PL;POS;INTR
tüy	tüylerini	N;ACC;PL;PSS2S
izleyici	izleyicilerinin	N;GEN;PL;PSS3P
kılıf	kılıfınıza	N;DAT;SG;PSS2P
cinsel yönelim	cinsel yönelimlerini	N;ACC;SG;PSS3P
kist	kistlerdi	N;LGSPEC1;3S;PL;PST
oyuncak	oyuncaklarını	N;ACC;PL;PSS2S
yolundurmak	yolunduracaklar mı?	V;IND;3;PL;FUT;POS;INTR
tarım	tarımını	N;ACC;SG;PSS2S
bilişsel psikoloji	bilişsel psikolojilerden	N;ABL;PL
gey	geylerine	N;DAT;SG;PSS3P
kapsam	kapsamdan	N;ABL;SG
öğütmek	öğütmüyor muydu?	V;IND;3;SG;PST;PROG;NEG;INTR
koşulmak	koşuldu mu?	V;IND;3;SG;PST;POS;INTR
bütünleşmek	bütünleşiyorlar mıydı?	V;IND;3;PL;PST;PROG;POS;INTR
soyut arayüz	soyut arayüzlerinden	N;ABL;PL;PSS2S
karınca	karıncaydım	N;LGSPEC1;1S;SG;PST
kraliçelik	kraliçeliklerini	N;ACC;SG;PSS3P
papaz	papazlarınız	N;NOM;PL;PSS2P
ışın	ışınını	N;ACC;SG;PSS2S
kılmak	kılacak mıyız?	V;IND;1;PL;FUT;POS;INTR
süsmek	süsersin	V;IND;2;SG;PRS;POS;DECL
prototipleme	prototiplemede	N;LOC;SG
jilet	jiletlerinin	N;GEN;PL;PSS3S
sultan	sultanınız	N;NOM;SG;PSS2P
aile	aileleri	N;ACC;PL
değişmek	değiştim	V;IND;1;SG;PST;POS;DECL
tensör	tensörlerinin	N;GEN;PL;PSS3P
aseksüel	aseksüelinde	N;LOC;SG;PSS3S
pembe dizi	pembe dizimizin	N;GEN;SG;PSS1P
kılmak	kılmıyorlar	V;IND;3;PL;PRS;PROG;NEG;DECL
lezyon	lezyonunu	N;ACC;SG;PSS3S
fonksiyon	fonksiyonumuza	N;DAT;SG;PSS1P
üretici	üreticilere	N;DAT;PL
aile planlaması	aile planlamasında	N;LOC;SG
nergis	nergislerimizi	N;ACC;PL;PSS1P
muşmula	muşmulalarda	N;LOC;PL
öncelik	önceliğiniz	N;NOM;SG;PSS2P
algoritma	algoritmamızı	N;ACC;SG;PSS1P
seven	sevenlerinin	N;GEN;PL;PSS3P
dirilmek	dirilmem	V;IND;1;SG;PRS;NEG;DECL
taşmak	taşacağım	V;IND;1;SG;FUT;POS;DECL
sihirli	sihirli değil miymişiz?	ADJ;LGSPEC1;LGSPEC2;1;PL;NEG;INTR
beklemek	beklemez misiniz?	V;IND;2;PL;PRS;NEG;INTR
kriz	krizimizde	N;LOC;SG;PSS1P
ateşe vermek	ateşe vermiyorsunuz	V;IND;2;PL;PRS;PROG;NEG;DECL
bitmek	bitmiyor muydum?	V;IND;1;SG;PST;PROG;NEG;INTR
gebermek	gebermeyecek misin?	V;IND;2;SG;FUT;NEG;INTR
cüzzam	cüzzamınızı	N;ACC;SG;PSS2P
tütsü	tütsümüze	N;DAT;SG;PSS1P
pusmak	pusmadın mı?	V;IND;2;SG;PST;NEG;INTR
süsmek	süsüyor muydunuz?	V;IND;2;PL;PST;PROG;POS;INTR
kürk	kürklerinin	N;GEN;PL;PSS3P
yuvarlamak	yuvarlamayacak mısın?	V;IND;2;SG;FUT;NEG;INTR
çedar	çedarı	N;ACC;SG
alt	altına	N;DAT;SG;PSS2S
sahip	sahiplerin	N;NOM;PL;PSS2S
kasmak	kasmadık mı?	V;IND;1;PL;PST;NEG;INTR
sözleşme	sözleşmelerinizden	N;ABL;PL;PSS2P
üzüm	üzümünde	N;LOC;SG;PSS2S
ıstakoz	ıstakozları	N;ACC;PL
kulağını bükmek	bükdünüz	V;IND;2;PL;PST;POS;DECL
eşek	eşeğimize	N;DAT;SG;PSS1P
eriyik	eriyiğinize	N;DAT;SG;PSS2P
oyalamak	oyalamazsınız	V;IND;2;PL;PRS;NEG;DECL
ateşe vermek	ateşe vermediniz mi?	V;IND;2;PL;PST;NEG;INTR
oyuncak	oyuncağı	N;ACC;SG
pöhrenk	pöhrenginde	N;LOC;SG;PSS2S
final sınıf	final sınıfını	N;ACC;SG;PSS3S
durmak	durursun	V;IND;2;SG;PRS;POS;DECL
erkenek	erkeneklerimizin	N;GEN;PL;PSS1P
ovmak	ovuyoruz	V;IND;1;PL;PRS;PROG;POS;DECL
canlandırtılmak	canlandırtılmıyor mu?	V;IND;3;SG;PRS;PROG;NEG;INTR
enfeksiyon	enfeksiyonların	N;NOM;PL;PSS2S
aşık olmak	aşık olmuyoruz	V;IND;1;PL;PRS;PROG;NEG;DECL
yaptırmak	yaptırtılar	V;IND;3;PL;PST;POS;DECL
bayılmak	bayılıyor muydum?	V;IND;1;SG;PST;PROG;POS;INTR
diş fırçası	diş fırçasında	N;LOC;SG
içermek	içeriyorduk	V;IND;1;PL;PST;PROG;POS;DECL
kapmak	kapmaz mıyız?	V;IND;1;PL;PRS;NEG;INTR
koymak	koyuyor musun?	V;IND;2;SG;PRS;PROG;POS;INTR
aşık attırmak	aşık attırmadı mı?	V;IND;3;SG;PST;NEG;INTR
asıl	asıllardan	N;ABL;PL
mümessil	mümessillerini	N;ACC;PL;PSS3S
şelale	şelalelerimizi	N;ACC;PL;PSS1P
canlanmak	canlanmadım mı?	V;IND;1;SG;PST;NEG;INTR
kazımak	kazıyor muyduk?	V;IND;1;PL;PST;PROG;POS;INTR
tekfur	tekfurlardım	N;LGSPEC1;1S;PL;PST
nutuk	nutuklarından	N;ABL;SG;PSS3P
arzuhalci	arzuhalcilersiniz	N;LGSPEC1;2P;PL;PRS
sürüngen	sürüngenlerimizden	N;ABL;PL;PSS1P
moda	modalarınızı	N;ACC;PL;PSS2P
kimlik	kimliğiniz	N;NOM;SG;PSS2P
öç	öcünüzde	N;LOC;SG;PSS2P
çeç	çeçleri	N;NOM;PL;PSS3S
eşantiyon	eşantiyonunu	N;ACC;SG;PSS2S
çavuş	çavuşunu	N;ACC;SG;PSS3S
yanlış	yanlış mıyız?	ADJ;LGSPEC1;PRS;1;PL;POS;INTR
deney	deneyine	N;DAT;SG;PSS3S
tabansız	tabansızlar	N;NOM;PL
nişanlı	nişanlılarını	N;ACC;PL;PSS3P
çar	çarlardık	N;LGSPEC1;1P;PL;PST
sürüngen	sürüngenlerini	N;ACC;SG;PSS3P
âşık olmak	âşık olmaz	V;IND;3;SG;PRS;NEG;DECL
flaş	flaşlarının	N;GEN;PL;PSS3S
çarşaf	çarşaflarının	N;GEN;PL;PSS3P
fikoloji	fikolojilerin	N;GEN;PL
olta	oltalarından	N;ABL;PL;PSS3S
katmak	katacak mıyız?	V;IND;1;PL;FUT;POS;INTR
kırıtmak	kırıtmadım mı?	V;IND;1;SG;PST;NEG;INTR
parça	parçama	N;DAT;SG;PSS3P
ders	ders	N;NOM;SG
rüya	rüyalarımız	N;NOM;PL;PSS1P
küremek	küreyecek	V;IND;3;SG;FUT;POS;DECL
dev	devlerimizin	N;GEN;PL;PSS1P
bıyık	bıyıklarınıza	N;DAT;PL;PSS2P
keşkek	keşkeklerimizden	N;ABL;PL;PSS1P
iletmek	iletmiyordu	V;IND;3;SG;PST;PROG;NEG;DECL
çökermek	çökermeyeceksin	V;IND;2;SG;FUT;NEG;DECL
uzanmak	uzanırlar	V;IND;3;PL;PRS;POS;DECL
saksafon	saksafonlarımızı	N;ACC;PL;PSS1P
ileri	ilerinde	N;LOC;SG;PSS2S
dilsizlik	dilsizliklerden	N;ABL;PL
sayım	sayımda	N;LOC;SG
konser	konserlerini	N;ACC;SG;PSS3P
bağırsak	bağırsaklarına	N;DAT;PL;PSS2S
haberleşmek	haberleşmiyor musunuz?	V;IND;2;PL;PRS;PROG;NEG;INTR
röportaj	röportajında	N;LOC;SG;PSS2S
gün	gününün	N;GEN;SG;PSS2S
çağırmak	çağırmazsın	V;IND;2;SG;PRS;NEG;DECL
olumluluk	olumluluk	N;NOM;SG
varış	varışı	N;ACC;SG
paylaştırma	paylaştırmalarımızda	N;LOC;PL;PSS1P
teorem	teoremlerinden	N;ABL;SG;PSS3P
Zagrepli	Zagreplilerinizde	N;LOC;PL;PSS2P
negatif sayı	negatif sayılarından	N;ABL;PL;PSS2S
öküz	öküzdüler	N;LGSPEC1;3P;SG;PST
yerel değişken	yerel değişkenlermişsiniz	N;LGSPEC1;2P;PL;LGSPEC2
voleybolcu	voleybolculardınız	N;LGSPEC1;2P;PL;PST
yengeç	yengecin	N;GEN;SG
fıstık	fıstıklarından	N;ABL;SG;PSS3P
fotoğraf	fotoğrafımızdan	N;ABL;SG;PSS1P
susmak	susmuyor muydum?	V;IND;1;SG;PST;PROG;NEG;INTR
merdiven	merdivenlerinize	N;DAT;PL;PSS2P
şey	şeylerinde	N;LOC;SG;PSS3P
akciğer	akciğerlerini	N;ACC;PL;PSS2S
klavye	klavyelerinde	N;LOC;PL;PSS3S
sokak	sokağımızın	N;GEN;SG;PSS1P
laterna	laternasının	N;GEN;SG;PSS3S
sokak	sokakları	N;NOM;SG;PSS3P
kirletmek	kirletiyorlar mıydı?	V;IND;3;PL;PST;PROG;POS;INTR
alındırtmak	alındırtmıyorlar	V;IND;3;PL;PRS;PROG;NEG;DECL
karıştırtmak	karıştırtdınız mı?	V;IND;2;PL;PST;POS;INTR
öldürtmek	öldürtecekler mi?	V;IND;3;PL;FUT;POS;INTR
ikilem	ikileminizde	N;LOC;SG;PSS2P
basit kelime	basit kelimelerin	N;GEN;PL
kanıtlamak	kanıtlıyorum	V;IND;1;SG;PRS;PROG;POS;DECL
sinematograf	sinematograflarımız	N;NOM;PL;PSS1P
kaynaç	kaynacının	N;GEN;SG;PSS3S
hendese	hendesesinin	N;GEN;SG;PSS3S
leş	leşlerinden	N;ABL;SG;PSS3P
alkış	alkışında	N;LOC;SG;PSS2S
otomobil	otomobili	N;NOM;SG;PSS3S
yoğurtçu	yoğurtçundan	N;ABL;SG;PSS2S
çift	çiftlere	N;DAT;PL
belde	beldenizi	N;ACC;SG;PSS2P
böbrek	böbreğine	N;DAT;SG;PSS3S
anasızlık	anasızlığınızda	N;LOC;SG;PSS2P
ölçülmek	ölçülmüyor musun?	V;IND;2;SG;PRS;PROG;NEG;INTR
deli	delilerini	N;ACC;PL;PSS3P
yeterlik	yeterliklerini	N;ACC;SG;PSS3P
seçmek	seçmiyor muyduk?	V;IND;1;PL;PST;PROG;NEG;INTR
şehvet	şehvetin	N;GEN;SG
pembe dizi	pembe dizimizi	N;ACC;SG;PSS1P
tütü	tütülerinde	N;LOC;PL;PSS3P
yabancı anahtar	yabancı anahtarlarının	N;GEN;SG;PSS3P
burkmak	burktum mu?	V;IND;1;SG;PST;POS;INTR
net	netlerinden	N;ABL;PL;PSS2S
sünmek	sünüyorlardı	V;IND;3;PL;PST;PROG;POS;DECL
tamlayan durumu	tamlayan durumu	N;NOM;SG
gelinmek	gelinmiyordunuz	V;IND;2;PL;PST;PROG;NEG;DECL
kestirme	kestirmelerinde	N;LOC;PL;PSS2S
ilerletmek	ilerletmiyordu	V;IND;3;SG;PST;PROG;NEG;DECL
turşu	turşularmış	N;LGSPEC1;3P;PL;LGSPEC2
işçi	işçilerinde	N;LOC;PL;PSS2S
fevt olmak	fevt olur mu?	V;IND;3;SG;PRS;POS;INTR
sayfa	sayfaydılar	N;LGSPEC1;3P;SG;PST
sevap	sevaplarından	N;ABL;PL;PSS3S
şampiyonluk	şampiyonluğun	N;GEN;SG
sululuk	sululuğumuza	N;DAT;SG;PSS1P
verilmek	verildim	V;IND;1;SG;PST;POS;DECL
nutuk	nutkun	N;GEN;SG
karmaşık sayı	karmaşık sayıları	N;NOM;PL;PSS3S
jaluzi	jaluzilerinin	N;GEN;PL;PSS3S
sikişmek	sikiştiniz mi?	V;IND;2;PL;PST;POS;INTR
izlence	izlencelerine	N;DAT;PL;PSS3P
nokta	noktalarınıza	N;DAT;PL;PSS2P
ebe	ebeleriniz	N;NOM;PL;PSS2P
uğratmak	uğrattın	V;IND;2;SG;PST;POS;DECL
lord	lordumda	N;LOC;SG;PSS3P
kötüleşmek	kötüleşmiyorlar mıydı?	V;IND;3;PL;PST;PROG;NEG;INTR
eskimek	eskemeyecekler	V;IND;3;PL;FUT;NEG;DECL
bitirtmek	bitirtmediler mi?	V;IND;3;PL;PST;NEG;INTR
başrahip	başrahiplerden	N;ABL;PL
abazan	abazan değil miydim?	ADJ;LGSPEC1;PST;1;SG;NEG;INTR
pabuç	pabucunu	N;ACC;SG;PSS2S
dalgalanmak	dalgalanmıyor muydunuz?	V;IND;2;PL;PST;PROG;NEG;INTR
ülke	ülkede	N;LOC;SG
üzülmek	üzülmüyordum	V;IND;1;SG;PST;PROG;NEG;DECL
kefir	kefirlerimiz	N;NOM;PL;PSS1P
günah	günahına	N;DAT;SG;PSS3S
almak	almayacağım	V;IND;1;SG;FUT;NEG;DECL
yoksullaştırmak	yoksullaştırdım mı?	V;IND;1;SG;PST;POS;INTR
programlattırmak	programlattırıyorlar mıydı?	V;IND;3;PL;PST;PROG;POS;INTR
tabansız	tabansızlarınızı	N;ACC;PL;PSS2P
elektrik-elektronik mühendisliği	elektrik-elektronik mühendisliğinin	N;GEN;SG
aşçı	aşçılardınız	N;LGSPEC1;2P;PL;PST
zürriyet	zürriyetlerini	N;ACC;PL;PSS2S
merkez	merkezden	N;ABL;SG
ninni	ninniydi	N;LGSPEC1;3S;SG;PST
kokmak	koktular	V;IND;3;PL;PST;POS;DECL
tekfur	tekfurları	N;NOM;PL;PSS3S
istemci	istemcilerini	N;ACC;PL;PSS3P
fulya	fulyalarından	N;ABL;PL;PSS3P
insanımsı	insanımsılarınızdan	N;ABL;PL;PSS2P
anjiyo	anjiyolarından	N;ABL;PL;PSS2S
tükürmek	tükürüyor muyuz?	V;IND;1;PL;PRS;PROG;POS;INTR
göçmek	göçeceksin	V;IND;2;SG;FUT;POS;DECL
homoseksüel	homoseksüelimizden	N;ABL;SG;PSS1P
kitabe	kitabemiz	N;NOM;SG;PSS1P
krizantem	krizantemlerimizi	N;ACC;PL;PSS1P
olay güdümlü programlama	olay güdümlü programlamalarımızda	N;LOC;PL;PSS1P
kitabe	kitabelerinizin	N;GEN;PL;PSS2P
mekik	mekiğinde	N;LOC;SG;PSS2S
pembe dizi	pembe diziden	N;ABL;SG
bulgur	bulgurun	N;NOM;SG;PSS2S
otomobilcilik	otomobilcilikmişiz	N;LGSPEC1;1P;SG;LGSPEC2
güreşçi	güreşçinde	N;LOC;SG;PSS2S
konmak	konmayacaksın	V;IND;2;SG;FUT;NEG;DECL
rakı	rakılarından	N;ABL;PL;PSS3S
örtmek	örttük	V;IND;1;PL;PST;POS;DECL
mümessillik	mümessilliklermişsin	N;LGSPEC1;2S;PL;LGSPEC2
açmak	açmıyordu	V;IND;3;SG;PST;PROG;NEG;DECL
acıktırtmak	acıktırtırsın	V;IND;2;SG;PRS;POS;DECL
sıkmak	sıkar mıyız?	V;IND;1;PL;PRS;POS;INTR
ateş	ateşlerini	N;ACC;SG;PSS3P
geri yazma	geri yazmamı	N;ACC;SG;PSS3P
sanmak	sanırlar	V;IND;3;PL;PRS;POS;DECL
mısra	mısralarınıza	N;DAT;PL;PSS2P
mandalina	mandalinalarına	N;DAT;PL;PSS2S
akrep	akrebinden	N;ABL;SG;PSS2S
koku	kokusunun	N;GEN;SG;PSS3S
ayna	aynaya	N;DAT;SG
totemcilik	totemciliklere	N;DAT;PL
yavru	yavrulardım	N;LGSPEC1;1S;PL;PST
kartal	kartallarınızı	N;ACC;PL;PSS2P
fortlamak	fortlıyorsunuz	V;IND;2;PL;PRS;PROG;POS;DECL
kalamar	kalamardılar	N;LGSPEC1;3P;SG;PST
metrdotel	metrdotelinizden	N;ABL;SG;PSS2P
kışkırtmak	kışkırtıyoruz	V;IND;1;PL;PRS;PROG;POS;DECL
madalya	madalyada	N;LOC;SG
kırdırmak	kırdırdı mı?	V;IND;3;SG;PST;POS;INTR
kusma	kusmalarda	N;LOC;PL
algoritma	algoritmanda	N;LOC;SG;PSS2S
sözcülük	sözcülüklerimizden	N;ABL;PL;PSS1P
savunmak	savunmuyordun	V;IND;2;SG;PST;PROG;NEG;DECL
gülünçleşmek	gülünçleşiyoruz	V;IND;1;PL;PRS;PROG;POS;DECL
kalmak	kalacağız	V;IND;1;PL;FUT;POS;DECL
sağduyu	sağduyum	N;NOM;SG;PSS3P
kayak	kayaklarının	N;GEN;PL;PSS2S
yormak	yormayacak mı?	V;IND;3;SG;FUT;NEG;INTR
tecrübe	tecrübelerinden	N;ABL;PL;PSS3P
papirüs	papirüslerimiz	N;NOM;PL;PSS1P
kara delik	kara deliklerde	N;LOC;PL
delirmek	delirmez mi?	V;IND;3;SG;PRS;NEG;INTR
ıspanak	ıspanağından	N;ABL;SG;PSS2S
kağıt	kağıtlarında	N;LOC;PL;PSS2S
şampanya	şampanyamızı	N;ACC;SG;PSS1P
denizanası	denizanasına	N;DAT;SG
dergi	dergilerinden	N;ABL;PL;PSS2S
ilişkisel model	ilişkisel modeli	N;ACC;SG
pandispanya	pandispanyaydın	N;LGSPEC1;2S;SG;PST
kötüleşmek	kötüleşmedin mi?	V;IND;2;SG;PST;NEG;INTR
otoculuk	otoculuklar	N;LGSPEC1;3P;SG;PRS
laterna	laternaya	N;DAT;SG
gemi	gemiye	N;DAT;SG
ulumak	ulumuyor muydum?	V;IND;1;SG;PST;PROG;NEG;INTR
server	serverlerimizi	N;ACC;PL;PSS1P
başkent	başkentleri	N;ACC;PL
döndürmek	döndürüyorduk	V;IND;1;PL;PST;PROG;POS;DECL
tecrübe	tecrübenizi	N;ACC;SG;PSS2P
idare	idarelerinden	N;ABL;PL;PSS2S
mihrap	mihraplarınıza	N;DAT;PL;PSS2P
çizgi	çizgiydim	N;LGSPEC1;1S;SG;PST
fikoloji	fikolojinin	N;GEN;SG
üzgün	üzgünüz	ADJ;LGSPEC1;PRS;1;PL;POS;DECL
atıştırmak	atıştırıyor muydum?	V;IND;1;SG;PST;PROG;POS;INTR
göndermek	gönderecekler mi?	V;IND;3;PL;FUT;POS;INTR
ana bina	ana binalarınızda	N;LOC;PL;PSS2P
cenup	cenupların	N;NOM;PL;PSS2S
ilerletmek	ilerletecekler	V;IND;3;PL;FUT;POS;DECL
yakın	yakınlarınızdan	N;ABL;PL;PSS2P
tükürmek	tüküreceğim	V;IND;1;SG;FUT;POS;DECL
ulumak	ulumuyordum	V;IND;1;SG;PST;PROG;NEG;DECL
ofis	ofislerinizden	N;ABL;PL;PSS2P
toprak olmak	toprak olmaz mı?	V;IND;3;SG;PRS;NEG;INTR
çürümek	çürüyorlar mı?	V;IND;3;PL;PRS;PROG;POS;INTR
deyim	deyimi	N;NOM;SG;PSS3S
karın	karnımıza	N;DAT;SG;PSS1P
gecikmek	gecikmiyor muyum?	V;IND;1;SG;PRS;PROG;NEG;INTR
şişlik	şişliklerinizin	N;GEN;PL;PSS2P
konjenital defekt	konjenital defektin	N;NOM;SG;PSS2S
mümkün kılma	mümkün kılmalarımızı	N;ACC;PL;PSS1P
baytar	baytarlarının	N;GEN;PL;PSS3S
toz	tozunuzda	N;LOC;SG;PSS2P
ölçtürmek	ölçtürmüyor muyuz?	V;IND;1;PL;PRS;PROG;NEG;INTR
bastırma	bastırmamı	N;ACC;SG;PSS3P
bağ	bağınızı	N;ACC;SG;PSS2P
saçmak	saçtılar	V;IND;3;PL;PST;POS;DECL
senaryo	senaryoma	N;DAT;SG;PSS3P
kul	kullara	N;DAT;PL
üre	üresinde	N;LOC;SG;PSS3S
düzine	düzinenizin	N;GEN;SG;PSS2P
içmek	içmediler	V;IND;3;PL;PST;NEG;DECL
boğa	boğaya	N;DAT;SG
dilim	dilimlerin	N;NOM;PL;PSS2S
gelinmek	geliniyor muyuz?	V;IND;1;PL;PRS;PROG;POS;INTR
umur	umurların	N;NOM;PL;PSS2S
dünür	dünürüne	N;DAT;SG;PSS2S
albatros	albatroslarını	N;ACC;PL;PSS2S
hayvanat bahçesi	hayvanat bahçesinin	N;GEN;SG
günah	günahımızı	N;ACC;SG;PSS1P
büktürmek	büktürmeyeceksiniz	V;IND;2;PL;FUT;NEG;DECL
vurmak	vurmuyor muyum?	V;IND;1;SG;PRS;PROG;NEG;INTR
sözleşme	sözleşmenize	N;DAT;SG;PSS2P
dinleti	dinletinin	N;GEN;SG;PSS2S
odacı	odacılarını	N;ACC;PL;PSS3P
meşrubat	meşrubata	N;DAT;SG
tensör	tensörlerde	N;LOC;PL
tekfur	tekfurlarınızda	N;LOC;PL;PSS2P
çıldırtmak	çıldırtmıyor muydu?	V;IND;3;SG;PST;PROG;NEG;INTR
öpmek	öpmeyecek	V;IND;3;SG;FUT;NEG;DECL
ot	otunu	N;ACC;SG;PSS2S
banka	bankalarımızda	N;LOC;PL;PSS1P
şampiyonluk	şampiyonluğundan	N;ABL;SG;PSS2S
hamster	hamsterimizin	N;GEN;SG;PSS1P
basın	basınımızdan	N;ABL;SG;PSS1P
papatya	papatyalarını	N;ACC;PL;PSS3S
işkenceci	işkencecimize	N;DAT;SG;PSS1P
flaş	flaşlarmış	N;LGSPEC1;3S;PL;LGSPEC2
pozitif sayı	pozitif sayılarına	N;DAT;PL;PSS3S
davranış	davranışlarını	N;ACC;PL;PSS3P
dinozor	dinozorlardı	N;LGSPEC1;3S;PL;PST
maske	maskesine	N;DAT;SG;PSS3S
dilmek	dileceksiniz	V;IND;2;PL;FUT;POS;DECL
ped	pedlerine	N;DAT;SG;PSS3P
kaldıraç	kaldıraçların	N;NOM;PL;PSS2S
ağ	ağlarının	N;GEN;PL;PSS3P
çağanoz	çağanozlara	N;DAT;PL
ropdöşambır	ropdöşambırlarında	N;LOC;PL;PSS2S
ciklet	cikletlerinden	N;ABL;PL;PSS2S
balalayka	balalaykamın	N;GEN;SG;PSS3P
çarpmak	çarpıyor musunuz?	V;IND;2;PL;PRS;PROG;POS;INTR
pehlivan	pehlivanlar	N;LGSPEC1;3S;PL;PRS
göt yanağı	göt yanağında	N;LOC;SG
programlattırmak	programlattırıyordunuz	V;IND;2;PL;PST;PROG;POS;DECL
sakal	sakalımız	N;NOM;SG;PSS1P
bedevi	bedevisine	N;DAT;SG;PSS3S
övgü	övgülerimizin	N;GEN;PL;PSS1P
hayvanat bahçesi	hayvanat bahçelerinden	N;ABL;PL
tutku	tutkulardır	N;LGSPEC1;3P;PL;PRS
öpmek	öpmüyor	V;IND;3;SG;PRS;PROG;NEG;DECL
top	toplardan	N;ABL;PL
ortam	ortamınızdan	N;ABL;SG;PSS2P
asteroit	asteroidi	N;NOM;SG;PSS3S
kraker	krakerlerimize	N;DAT;PL;PSS1P
diri	diri	ADJ;LGSPEC1;PRS;3;SG;POS;DECL
külfet	külfetimizin	N;GEN;SG;PSS1P
sunucu	sunucu	N;NOM;SG
erime	erimesinde	N;LOC;SG;PSS3S
kılkapan	kılkapanlarınızda	N;LOC;PL;PSS2P
dövüşmek	dövüşmüyordu	V;IND;3;SG;PST;PROG;NEG;DECL
elmas	elmasımızdan	N;ABL;SG;PSS1P
sikişmek	sikişiyor muydu?	V;IND;3;SG;PST;PROG;POS;INTR
maymun	maymunlarında	N;LOC;PL;PSS2S
şey	şeylerine	N;DAT;PL;PSS3S
cihan	cihanlarız	N;LGSPEC1;1P;PL;PRS
kara sinek	kara sineğinizi	N;ACC;SG;PSS2P
üstdil	üstdillerini	N;ACC;SG;PSS3P
sunu	sunulardır	N;LGSPEC1;3P;PL;PRS
şaşırttırmak	şaşırttıracaklar	V;IND;3;PL;FUT;POS;DECL
kayıt	kayıtlarımız	N;NOM;PL;PSS1P
ateşe vermek	ateşe vermiyor musun?	V;IND;2;SG;PRS;PROG;NEG;INTR
eğmek	eğmedim mi?	V;IND;1;SG;PST;NEG;INTR
göndermek	gönderiyordum	V;IND;1;SG;PST;PROG;POS;DECL
bitirtmek	bitirtmedik mi?	V;IND;1;PL;PST;NEG;INTR
artmak	artmayacak	V;IND;3;SG;FUT;NEG;DECL
şamdan	şamdanda	N;LOC;SG
mutlak sıfır	mutlak sıfıra	N;DAT;SG
birleşik sözcük	birleşik sözcüklerine	N;DAT;PL;PSS3P
çalgı	çalgını	N;ACC;SG;PSS2S
artmak	artmaz	V;IND;3;SG;PRS;NEG;DECL
heyecanlandırmak	heyecanlandırmazsınız	V;IND;2;PL;PRS;NEG;DECL
yarasa	yarasasında	N;LOC;SG;PSS3S
bulamak	buluyorlardı	V;IND;3;PL;PST;PROG;POS;DECL
kamera	kameralardın	N;LGSPEC1;2S;PL;PST
uçmak	uçmam	V;IND;1;SG;PRS;NEG;DECL
anjiyo	anjiyolarını	N;ACC;PL;PSS3P
tanımak	tanıdık mı?	V;IND;1;PL;PST;POS;INTR
zırtgel	zırtgellerinde	N;LOC;PL;PSS3P
müselles	müselleslerde	N;LOC;PL
yüzüncü	yüzüncülerinin	N;GEN;PL;PSS3P
uzaktan kumanda	uzaktan kumandan	N;NOM;SG;PSS2S
saksı	saksıya	N;DAT;SG
asimptot	asimptotlarımızı	N;ACC;PL;PSS1P
diremek	diremeyecek	V;IND;3;SG;FUT;NEG;DECL
kümbet	kümbet	N;NOM;SG
vaha	vahaymışsınız	N;LGSPEC1;2P;SG;LGSPEC2
yenilik	yeniliğinden	N;ABL;SG;PSS2S
sepet	sepeti	N;NOM;SG;PSS3S
kalamar	kalamarmışlar	N;LGSPEC1;3P;SG;LGSPEC2
pişirmek	pişirmiyorlar	V;IND;3;PL;PRS;PROG;NEG;DECL
sunmak	sunduk mu?	V;IND;1;PL;PST;POS;INTR
göstermek	göstermeyecekler mi?	V;IND;3;PL;FUT;NEG;INTR
yoksullaştırmak	yoksullaştırıyordu	V;IND;3;SG;PST;PROG;POS;DECL
birincil anahtar	birincil anahtarlarını	N;ACC;PL;PSS2S
vekil	vekilinizden	N;ABL;SG;PSS2P
otomobil	otomobilmişsiniz	N;LGSPEC1;2P;SG;LGSPEC2
seccade	seccadelerimiz	N;NOM;PL;PSS1P
batmak	battık mı?	V;IND;1;PL;PST;POS;INTR
ayakkabı	ayakkabılar	N;LGSPEC1;3S;PL;PRS
müşteri	müşteriydin	N;LGSPEC1;2S;SG;PST
yapıncak	yapıncaklarına	N;DAT;SG;PSS3P
bekletmek	bekletecek mi?	V;IND;3;SG;FUT;POS;INTR
kaybolmak	kaybolmadınız mı?	V;IND;2;PL;PST;NEG;INTR
gizlemek	gizliyor muydum?	V;IND;1;SG;PST;PROG;POS;INTR
bitim	bitimlermişsiniz	N;LGSPEC1;2P;PL;LGSPEC2
dinmek	dinmiyordum	V;IND;1;SG;PST;PROG;NEG;DECL
yardımcı	yardımcılarsın	N;LGSPEC1;2S;PL;PRS
tabiyet	tabiyetlerine	N;DAT;PL;PSS3P
düldül	düldüllerinden	N;ABL;PL;PSS2S
yıpranmak	yıpranıyorum	V;IND;1;SG;PRS;PROG;POS;DECL
müzikal	müzikalden	N;ABL;SG
mıh	mıhlarında	N;LOC;SG;PSS3P
seri katil	seri katillerim	N;LGSPEC1;1S;PL;PRS
aikido	aikidolarınızın	N;GEN;PL;PSS2P
ayrılmak	ayrılmıyor muyduk?	V;IND;1;PL;PST;PROG;NEG;INTR
dağılma	dağılmada	N;LOC;SG
meşrubat	meşrubatlarına	N;DAT;PL;PSS3P
çapa	çapalarına	N;DAT;PL;PSS3P
müzikal	müzikalinize	N;DAT;SG;PSS2P
yalın hal	yalın halimizden	N;ABL;SG;PSS1P
kovmamak	kovmadın	V;IND;2;SG;PST;NEG;DECL
kalıbı değiştirmek	kalıbı değiştirmeyecek misiniz?	V;IND;2;PL;FUT;NEG;INTR
börülce	börülcelermişsin	N;LGSPEC1;2S;PL;LGSPEC2
gol	golümde	N;LOC;SG;PSS3P
eğlenmek	eğlenecekler	V;IND;3;PL;FUT;POS;DECL
mana	manalarında	N;LOC;PL;PSS3S
inanmak	inandı	V;IND;3;SG;PST;POS;DECL
toplamak	topluyor muydu?	V;IND;3;SG;PST;PROG;POS;INTR
köfte	köftene	N;DAT;SG;PSS2S
ayvaz	ayvazlarmışsınız	N;LGSPEC1;2P;PL;LGSPEC2
abacı	abacıydık	N;LGSPEC1;1P;SG;PST
öldürtülmemek	öldürtülürler mi?	V;IND;3;PL;PRS;POS;INTR
koruyucu	koruyucunuzun	N;GEN;SG;PSS2P
ibnelik	ibneliğin	N;GEN;SG
iletmek	iletmedi	V;IND;3;SG;PST;NEG;DECL
pelikan	pelikanları	N;ACC;PL
dindarlık	dindarlığının	N;GEN;SG;PSS3S
körfez	körfezlerinizden	N;ABL;PL;PSS2P
kedicik	kediciklerinde	N;LOC;PL;PSS3S
yıkamak	yıkayacak mıyız?	V;IND;1;PL;FUT;POS;INTR
çubuk	çubuğumuza	N;DAT;SG;PSS1P
marul	marulunuzu	N;ACC;SG;PSS2P
kaynaç	kaynaçları	N;NOM;PL;PSS3S
olay	olaylarınızın	N;GEN;PL;PSS2P
ütü	ütümden	N;ABL;SG;PSS3P
tabansız	tabansızdılar	N;LGSPEC1;3P;SG;PST
incir	incirlerimizi	N;ACC;PL;PSS1P
tutku	tutkularımız	N;NOM;PL;PSS1P
ağa	ağalarınızın	N;GEN;PL;PSS2P
gezmek	gezmeyeceksin	V;IND;2;SG;FUT;NEG;DECL
heykelcik	heykelciklerimizi	N;ACC;PL;PSS1P
fibrinojen	fibrinojenlerimize	N;DAT;PL;PSS1P
helak olmak	helak oluyor muyum?	V;IND;1;SG;PRS;PROG;POS;INTR
sanat	sanatımızda	N;LOC;SG;PSS1P
içecek	içeceklerinden	N;ABL;SG;PSS3P
şov	şova	N;DAT;SG
ernek	erneğinizden	N;ABL;SG;PSS2P
sos	soslarımızı	N;ACC;PL;PSS1P
sapmak	sapmaz	V;IND;3;SG;PRS;NEG;DECL
hazcılık	hazcılığımızda	N;LOC;SG;PSS1P
ovmak	ovar mıyız?	V;IND;1;PL;PRS;POS;INTR
ahize	ahizelerinizden	N;ABL;PL;PSS2P
umutsuz	umutsuz değilim	ADJ;LGSPEC1;PRS;1;SG;NEG;DECL
ılımak	ılıyacak mısınız?	V;IND;2;PL;FUT;POS;INTR
vişne	vişneyi	N;ACC;SG
gaga	gaganın	N;GEN;SG
avcı sinek	avcı sinek	N;NOM;SG
Vikipedi	Vikipediler	N;NOM;PL
bölge	bölgemizde	N;LOC;SG;PSS1P
aznavur	aznavurlarınıza	N;DAT;PL;PSS2P
badem	bademinizden	N;ABL;SG;PSS2P
iğne	iğnesinin	N;GEN;SG;PSS3S
asıl	asıldan	N;ABL;SG
yetkili sunucu	yetkili sunucularım	N;LGSPEC1;1S;PL;PRS
koz	kozlardı	N;LGSPEC1;3P;PL;PST
yer	yerlerinin	N;GEN;PL;PSS3P
kıç	kıçlarımızdan	N;ABL;PL;PSS1P
artçı sarsıntı	artçı sarsıntılarınızdan	N;ABL;PL;PSS2P
süzmek	süzmedik mi?	V;IND;1;PL;PST;NEG;INTR
katılaşmak	katılaşır mıyım?	V;IND;1;SG;PRS;POS;INTR
masumiyet	masumiyetlerine	N;DAT;PL;PSS3P
haber	haberlerde	N;LOC;PL
tutulma	tutulmalarımız	N;NOM;PL;PSS1P
mühendis	mühendisinizden	N;ABL;SG;PSS2P
benzemek	benziyorlar mıydı?	V;IND;3;PL;PST;PROG;POS;INTR
kuzu	kuzularına	N;DAT;PL;PSS3S
arpa	arpalarından	N;ABL;PL;PSS3P
birleşme	birleşmelerine	N;DAT;PL;PSS2S
fortlamak	fortlamıyor mu?	V;IND;3;SG;PRS;PROG;NEG;INTR
otostopçu	otostopçunuzdan	N;ABL;SG;PSS2P
kulağını bükmek	bükmedim mi?	V;IND;1;SG;PST;NEG;INTR
gitar	gitarlarından	N;ABL;SG;PSS3P
büktürtmemek	büktürtmediler mi?	V;IND;3;PL;PST;NEG;INTR
aldırtmak	aldırtmadık mı?	V;IND;1;PL;PST;NEG;INTR
bohça	bohçalarının	N;GEN;PL;PSS3S
hamburger	hamburgeri	N;NOM;SG;PSS3S
tatbik	tatbikleriniz	N;NOM;PL;PSS2P
elektrikli sandalye	elektrikli sandalyelerimiz	N;NOM;PL;PSS1P
Hakk'ın rahmetine kavuşmak	Hakk'ın rahmetine kavuşuyorlardı	V;IND;3;PL;PST;PROG;POS;DECL
başarmak	başarıyoruz	V;IND;1;PL;PRS;PROG;POS;DECL
kışkırtmak	kışkırtıyorlardı	V;IND;3;PL;PST;PROG;POS;DECL
saklamak	saklamıyorsunuz	V;IND;2;PL;PRS;PROG;NEG;DECL
fotoğraf	fotoğrafın	N;NOM;SG;PSS2S
sevişmek	sevişecek misin?	V;IND;2;SG;FUT;POS;INTR
kasmak	kasmaz	V;IND;3;SG;PRS;NEG;DECL
katılmak	katılmıyorlar mıydı?	V;IND;3;PL;PST;PROG;NEG;INTR
yedek	yedeklerin	N;NOM;PL;PSS2S
ayrılmak	ayrıldılar mı?	V;IND;3;PL;PST;POS;INTR
izlek	izleğinizden	N;ABL;SG;PSS2P
balta	baltalar	N;LGSPEC1;3P;SG;PRS
dük	düklerdi	N;LGSPEC1;3P;PL;PST
çalgı	çalgıları	N;NOM;PL;PSS3P
börülce	börülcelerinden	N;ABL;PL;PSS3S
yüzey	yüzeylerimize	N;DAT;PL;PSS1P
seks yapmak	seks yapmaz	V;IND;3;SG;PRS;NEG;DECL
garson	garsonlardan	N;ABL;PL
verilmek	verilmiyordun	V;IND;2;SG;PST;PROG;NEG;DECL
yaratı	yaratıydılar	N;LGSPEC1;3P;SG;PST
böbrek	böbreklerine	N;DAT;PL;PSS3S
yüksük	yüksüklerinizi	N;ACC;PL;PSS2P
serpmek	serpmediler mi?	V;IND;3;PL;PST;NEG;INTR
dürüm	dürümler	N;NOM;PL
valiz	valizlerine	N;DAT;PL;PSS3P
küpe	küpeleri	N;NOM;PL;PSS3S
aşiret	aşiretleriniz	N;NOM;PL;PSS2P
yörünge	yörüngelerinden	N;ABL;PL;PSS3S
akış	akışınıza	N;DAT;SG;PSS2P
hazcı	hazcımızdan	N;ABL;SG;PSS1P
üvey çocuk	üvey çocuklarından	N;ABL;PL;PSS3P
pamuk	pamuklarını	N;ACC;SG;PSS3P
süs	süslerinden	N;ABL;PL;PSS2S
güreşçi	güreşçimizi	N;ACC;SG;PSS1P
damlamak	damlamazsın	V;IND;2;SG;PRS;NEG;DECL
sansar	sansarlarımızın	N;GEN;PL;PSS1P
rehine	rehinesi	N;NOM;SG;PSS3S
zağar	zağardık	N;LGSPEC1;1P;SG;PST
iç iskelet	iç iskeletini	N;ACC;SG;PSS3S
mısra	mısralarımızı	N;ACC;PL;PSS1P
anahtar sözcük	anahtar sözcüklerinden	N;ABL;PL;PSS2S
çıldırtmak	çıldırtıyor muyduk?	V;IND;1;PL;PST;PROG;POS;INTR
makyaj yapmak	makyaj yapmayız	V;IND;1;PL;PRS;NEG;DECL
pırasa	pırasalardın	N;LGSPEC1;2S;PL;PST
aseton	asetonlarına	N;DAT;PL;PSS3P
bıkmak	bıkacağız	V;IND;1;PL;FUT;POS;DECL
yanak	yanakları	N;ACC;PL
almak	alır mısın?	V;IND;2;SG;PRS;POS;INTR
havadan havaya füze	havadan havaya füzenizi	N;ACC;SG;PSS2P
gülünçleşmek	gülünçleşmiyorum	V;IND;1;SG;PRS;PROG;NEG;DECL
buharlaşmak	buharlaşmazsınız	V;IND;2;PL;PRS;NEG;DECL
kimyasal tepkime	kimyasal tepkimelerinin	N;GEN;PL;PSS3S
midye	midyelerinin	N;GEN;PL;PSS2S
