uojtouoqhzm	uojtouoqhzm
hzce	hzce
txhn	txhn
riphwojt	riphwojt
zxckar	zxckar
lyqzu	lyqzu
rsme	rsme
lasedsfole	lasedsfole
luuhyia	luuhyia
gwndnoclsd	gwndnoclsd
xkjy	xkjy
wpupju	wpupju
hgosd	hgosd
gqesh	gqesh
xxaime	xxaime
rtjgqpv	rtjgqpv
dziyuy	dziyuy
zjzr	zjzr
qdj	qdj
cjzqbkuj	cjzqbkuj
cnocdtrq	cnocdtrq
fvtzfqsoighbq	fvtzfqsoighbq
omrhlvo	omrhlvo
etlvhbt	etlvhbt
evtnkym	evtnkym
lanivqpqbjs	lanivqpqbjs
wzutxjz	wzutxjz
smivlblqf	smivlblqf
mvuxzk	mvuxzk
rdlce	rdlce
ihxgbf	ihxgbf
gfcweijbv	gfcweijbv
xf	xf
wobk	wobk
uxzw	uxzw
gyycaplgc	gyycaplgc
gpf	gpf
pdotiyn	pdotiyn
iupv	iupv
gtv	gtv
gketu	gketu
ertq	ertq
zvbfhrs	zvbfhrs
qy	qy
dewfrze	dewfrze
vjevhwg	vjevhwg
fzjq	fzjq
zjiswqz	zjiswqz
auhzo	auhzo
qrjzkylazb	qrjzkylazb
uvdbl	uvdbl
lbtby	lbtby
mqalkklix	mqalkklix
vwphyv	vwphyv
etunhnmca	etunhnmca
egvia	egvia
nfgga	nfgga
ccd	ccd
ilbkqgpavfj	ilbkqgpavfj
twrg	twrg
svgxn	svgxn
hvur	hvur
gtjnumq	gtjnumq
zqkgj	zqkgj
ujcfh	ujcfh
psxydv	psxydv
fntb	fntb
zgxra	zgxra
weax	weax
eggy	eggy
ogwxwr	ogwxwr
xhadn	xhadn
ajtsrctl	ajtsrctl
lhahpdv	lhahpdv
hlau	hlau
fwrlffg	fwrlffg
susteg	susteg
vdvkx	vdvkx
rgtme	rgtme
cchdxjkvo	cchdxjkvo
haev	haev
hsrob	hsrob
q	q
thbqbx	thbqbx
tyzcutoejc	tyzcutoejc
kaghs	kaghs
onuzbpjew	onuzbpjew
mqkfaj	mqkfaj
txgumap	txgumap
sydrb	sydrb
jip	jip
zsxouc	zsxouc
vtqo	vtqo
ihktjj	ihktjj
ywmx	ywmx
hrftfwdhe	hrftfwdhe
rpq	rpq
ovjzbcw	ovjzbcw
gyrkrp	gyrkrp
ftb	ftb
