eplnjcdd	eplnjcddeplnjcdd
p	pp
ibejfod	ibejfodibejfod
pab	pabpab
dlfcgbk	dlfcgbkdlfcgbk
olfop	olfopolfop
gcfohaobgcf	gcfohaobgcfgcfohaobgcf
ejnpc	ejnpcejnpc
mo	momo
pifg	pifgpifg
cjefakb	cjefakbcjefakb
o	oo
pjcjlek	pjcjlekpjcjlek
hehdgc	hehdgchehdgc
mmhf	mmhfmmhf
nih	nihnih
l	ll
hgahdmme	hgahdmmehgahdmme
llhekbhgg	llhekbhggllhekbhgg
fjmcif	fjmciffjmcif
kpkji	kpkjikpkji
dlef	dlefdlef
naljdol	naljdolnaljdol
dapf	dapfdapf
ae	aeae
pikn	piknpikn
kdnkma	kdnkmakdnkma
jmoe	jmoejmoe
hkcd	hkcdhkcd
bae	baebae
npdchffilp	npdchffilpnpdchffilp
feci	fecifeci
cfhm	cfhmcfhm
eb	ebeb
ej	ejej
kha	khakha
fhhen	fhhenfhhen
clobjl	clobjlclobjl
bdcnnfk	bdcnnfkbdcnnfk
apjnmed	apjnmedapjnmed
epopgd	epopgdepopgd
eoa	eoaeoa
mak	makmak
ilg	ilgilg
odnfeap	odnfeapodnfeap
jebn	jebnjebn
mo	momo
ijiele	ijieleijiele
efolbe	efolbeefolbe
hjfmp	hjfmphjfmp
g	gg
ohog	ohogohog
lmggl	lmggllmggl
ncbkj	ncbkjncbkj
bk	bkbk
odkcf	odkcfodkcf
ojnoi	ojnoiojnoi
eeaf	eeafeeaf
iljalco	iljalcoiljalco
cbod	cbodcbod
fjh	fjhfjh
cfkmlfe	cfkmlfecfkmlfe
bljo	bljobljo
gdejbbjh	gdejbbjhgdejbbjh
opofbihg	opofbihgopofbihg
koj	kojkoj
mn	mnmn
ne	nene
hkkjk	hkkjkhkkjk
bjlifgeo	bjlifgeobjlifgeo
blb	blbblb
neeb	neebneeb
dogb	dogbdogb
llenp	llenpllenp
acia	aciaacia
cceg	ccegcceg
ipbfghh	ipbfghhipbfghh
icbmm	icbmmicbmm
jiakjo	jiakjojiakjo
ndaek	ndaekndaek
minelhf	minelhfminelhf
fmcbh	fmcbhfmcbh
icmp	icmpicmp
oigkcacd	oigkcacdoigkcacd
efn	efnefn
jednkp	jednkpjednkp
eajcb	eajcbeajcb
calemkd	calemkdcalemkd
hokdk	hokdkhokdk
ahb	ahbahb
biikpho	biikphobiikpho
lbjdide	lbjdidelbjdide
kjlob	kjlobkjlob
jhhd	jhhdjhhd
aiffmono	aiffmonoaiffmono
gfnpe	gfnpegfnpe
bjbbkj	bjbbkjbjbbkj
jabie	jabiejabie
jmlokf	jmlokfjmlokf
hmjb	hmjbhmjb
